                         
  *   *   *   *   *   *  
  *   *   *   *   *   *  
  *   *   *   *   *   *  
  *   *   *   *   *   *  
  *   *   *   *   *   *  
                         
===========   ===========
                         
  *******       *******  
                         
   =   =         =   =   
   0   0    p    0   0   
   =   =         =   =   
                         
  *******       *******  
                         
						  