                         
  *   *   *   *   *   *  
  *   *   *   *   *   *  
  *   *   *   *   *   *  
  *   *   *   *   *   *  
  *   *   *   *   *   *  
                         
===========   ===========
                         
  *******       *******  
                         
   =   =         =   =   
   =   =    p    =   =   
   =   =         =   =   
                         
  *******       *******  
                         
						 